12 15
0 1 0 0 0 1 1 0 0 0 1 1 1 1 1
1 0 0 0 1 1 0 1 1 1 0 0 1 1 1
0 1 1 0 0 0 0 1 1 1 1 0 0 1 1
1 1 0 1 1 1 1 0 1 1 0 1 1 0 0
1 1 0 1 0 0 1 0 1 1 1 1 1 1 1
0 0 1 1 0 1 1 1 0 1 0 0 1 0 1
0 0 1 1 0 1 1 1 0 1 0 0 1 0 1
0 1 1 1 1 0 0 1 1 1 1 1 1 1 1
0 0 1 1 0 1 1 0 1 1 1 1 1 0 1
1 1 0 0 0 1 1 0 1 1 0 0 0 0 0
0 0 1 1 1 1 1 0 0 0 1 1 1 1 0
0 1 0 0 1 1 1 1 1 0 1 1 1 1 0

9 9
0 0 0 0 0 0 0 0 1
1 1 1 1 1 1 1 1 0
1 0 0 0 0 0 0 0 1
0 1 1 1 1 1 1 1 1
1 0 0 0 0 0 0 0 1
1 1 1 1 1 1 1 1 0
1 0 0 0 0 0 0 0 1
0 1 1 1 1 1 1 1 1
1 0 0 0 0 0 0 0 0


11 11
0 1 0 1 1 0 1 1 0 1 1
0 0 1 1 0 1 1 0 1 1 0
0 1 1 0 1 1 0 1 1 0 1
0 1 0 1 1 0 1 1 0 1 1
0 0 1 1 0 1 1 0 1 1 0
0 1 1 0 1 1 0 1 1 0 1
0 1 0 1 1 0 1 1 0 1 1
0 0 1 1 0 1 1 0 1 1 0
0 1 1 0 1 1 0 1 1 0 1
0 1 0 1 1 0 1 1 0 1 1
0 0 0 0 0 0 0 0 0 0 0

0 0
// additional maze: the worst case for this program